111111111111111111111111111
100000000000000000000010101
100000000000000000000010001
100000000000000000000000111
10000000000C0000000000000E1
100000P00000C00000000000001
100000000000C00000000000001
100000000000C00000000000001
100000000000C00000000000001
1000000000000C0000000000001
1000000000000C0000000000001
1000000000000C0000000000001
1000000000000C0000000000001
111111111111111111111111111