1111111
1PCE001
1000011
1111111